0,0,W,1,W,2,2,W,3,3,3,3
0,0,0,1,2,2,2,W,3,3,3,3
W,W,W,1,W,2,2,W,W,W,W,3
5,5,5,1,W,2,2,2,2,2,W,3
W,W,W,1,W,W,W,W,W,W,W,3
6,6,6,1,4,4,4,4,4,4,4,4
W,W,W,7,W,W,W,W,W,W,W,W
8,8,8,7,9,9,9,9,9,9,9,9
8,W,W,7,W,W,W,W,W,W,W,10
8,8,W,7,W,10,W,10,10,10,10,10
8,8,W,7,W,10,W,10,10,W,10,10
8,8,W,7,W,10,10,10,10,W,10,10