0,0,0,0,0,0,0,1,1,1,1,1,1
0,0,0,0,0,0,0,1,1,1,1,1,1
0,0,0,W,0,0,0,1,1,1,1,1,1
W,W,W,W,W,W,W,1,W,W,W,W,W
3,3,3,3,3,3,3,3,4,4,4,4,4
3,3,3,3,3,3,3,3,4,4,4,4,4
3,3,3,3,3,3,3,3,4,4,4,4,4
3,3,3,3,3,3,3,3,4,4,4,4,4
W,W,W,W,W,W,W,2,W,W,W,5,W
2,2,2,2,2,2,2,2,2,2,W,5,5
2,2,2,2,2,2,2,2,2,2,W,5,5
2,2,2,2,2,2,2,2,2,2,W,5,5
2,2,2,2,2,2,2,2,2,2,W,5,5