0,0,W,1,1,1
0,0,W,1,1,1
W,0,W,W,1,W
2,2,3,3,3,3
2,2,W,W,4,W
2,2,W,4,4,4